00000000000000000000-
44400444444440000000-
00400400000040000000-
00400444400040000000-
00400000400040000000-
00400044400040000000-
00400440000040000000-
00400400000040000000-
00444400000044444400-
00000000000000000000